# calibrated imu data gx(rad/s), gy(rad/s), gz(rad/s), ax(m/s^2), ay(m/s^2), az(m/s^2)
1.226971975000000093e+06 -1.770972026167653979e-03 -7.216310932373765086e-03 -2.587364520662381248e-03 9.375286174043475640e+00 -3.159653346691619902e-01 3.395331749834786805e+00 2.990429687500000000e+01
1.231950881000000052e+06 4.180204420581520863e-04 -1.179692007836444234e-02 -1.118689933105700314e-02 9.432892853422721657e+00 -3.436689662079435714e-01 3.492116881439080167e+00 2.990429687500000000e+01
1.236929787000000011e+06 -1.808027157171453181e-03 -1.090672378158295819e-02 -1.787868929531705869e-02 8.884429260166145426e+00 -3.845651861813879080e-01 3.229372211836038176e+00 2.993750000000000000e+01
1.241908692000000039e+06 -1.112763156856091951e-02 -6.609116061500426229e-03 -1.700330788547273209e-02 8.405573737826157910e+00 -2.086971743339618990e-01 2.979674033802356625e+00 2.993750000000000000e+01
1.246889597999999998e+06 -1.065115955035639966e-02 2.078113627382737697e-03 -1.782238672104144439e-02 8.794418823636073412e+00 -1.376795890291894198e-01 3.169386657910295391e+00 2.993750000000000000e+01
1.251865504000000190e+06 -7.236907861918669138e-03 1.165092075562573076e-02 -1.973965986910428128e-02 9.610513448175398210e+00 -1.353444102799564730e-01 3.550689257670263110e+00 2.992382812500000000e+01
1.256844410000000149e+06 -7.233382542660996006e-03 8.468997254587187079e-03 -2.000431115700681411e-02 1.012297286681994635e+01 -8.842355032894300138e-02 3.768083784612926479e+00 2.992382812500000000e+01
1.261823315999999875e+06 -2.801136636446731332e-03 -4.956984348417426203e-04 -1.734615337349239977e-02 9.628515535481414034e+00 -8.896575983600385484e-03 3.524521775390360823e+00 2.995898437500000000e+01
1.266802220999999903e+06 3.584972093772065271e-03 -3.376393086209343586e-03 -1.444257264206245429e-02 8.902431347472161249e+00 -3.532545846409185231e-02 3.256010615172625577e+00 2.995898437500000000e+01
1.271781127000000095e+06 4.812185980173966371e-03 3.266950242477941607e-03 -1.070337926652821341e-02 8.649201986034222855e+00 -9.912955514408661184e-02 3.149052353429953044e+00 2.992187500000000000e+01
1.276760033000000054e+06 3.583612550707507283e-03 1.799128704761427180e-02 -4.538642653704483623e-03 8.721210335258280821e+00 4.176478903298774803e-02 3.044539085100519404e+00 2.992187500000000000e+01
1.281738939000000246e+06 5.545578638289413304e-03 1.857581614485806845e-02 -4.018493432664438716e-03 9.105254864453257824e+00 4.775165872930242639e-02 3.282545532189895532e+00 2.994726562500000000e+01
1.286717844999999972e+06 4.323203513362794403e-03 1.712123283901212378e-02 -3.470204612922269533e-03 9.443694105806329731e+00 -3.778268917932170456e-02 3.536507831646714450e+00 2.994726562500000000e+01
1.291696750000000000e+06 -3.353173163015768510e-04 1.363779569680409823e-02 -5.306901485385913039e-03 9.508501620107983499e+00 4.410255774436389054e-02 3.550854545987990996e+00 2.994335937500000000e+01
1.296675655999999959e+06 -2.054785384227791889e-03 8.439281844325137449e-03 -9.043806522228898734e-03 9.544505794720011593e+00 -1.611470495721767371e-02 3.570364981656405590e+00 2.994335937500000000e+01
1.301653561999999918e+06 -7.673187049289563466e-03 3.761560262975083280e-03 -3.894243379624167528e-03 9.395688539656958937e+00 -7.872390974500365068e-02 3.556002100488877993e+00 2.991796875000000000e+01
1.306632468000000110e+06 -1.230692976736860039e-02 5.433002797273872066e-03 5.801869070254794467e-03 9.105254864453257824e+00 6.822442731392941440e-02 3.378935098211882426e+00 2.991796875000000000e+01
1.311611374000000069e+06 -1.034060620190988683e-02 7.165012665628989544e-03 8.467438553136710788e-03 8.748813535794171869e+00 8.993352718505587262e-02 3.194610214332083586e+00 2.993554687500000000e+01
1.316590280000000028e+06 -2.480391343349541700e-03 6.883652490343112121e-03 1.377120332267069668e-02 8.674404908262642877e+00 -4.373491813197150080e-02 3.240374258088727366e+00 2.993554687500000000e+01
1.321569184999999823e+06 -1.477547421360185520e-03 1.175831115755817877e-02 2.422303167546178970e-02 9.006843453847045211e+00 -3.653912758183885945e-02 3.453234513298284014e+00 2.995703125000000000e+01
1.326548091000000015e+06 2.210292542385368375e-03 1.550942103263775428e-02 2.982416400898295350e-02 9.554106907949886818e+00 3.446421293114609874e-02 3.620760172587129233e+00 2.995703125000000000e+01
